20
12
1

10 -1 -1 -1 -1 -1 -1 -1 -1 -1 -1 -1 -1 -1 -1 -1 -1 -1 -1 10
2 -1 -1 -1 -1 -1 -1 -1 -1 -1 -1 -1 -1 -1 -1 -1 -1 -1 -1 2
2 -1 -1 -1 -1 -1 -1 -1 -1 -1 -1 -1 -1 -1 -1 -1 -1 -1 -1 2
2 -1 -1 -1 -1 -1 -1 -1 -1 -1 -1 -1 -1 -1 -1 -1 -1 -1 -1 2
2 -1 -1 -1 -1 -1 -1 -1 -1 -1 -1 -1 4 12 5 -1 -1 -1 -1 2
2 -1 -1 -1 -1 -1 -1 -1 -1 4 7 -1 14 3 15 -1 -1 -1 -1 2
2 -1 -1 -1 -1 -1 -1 -1 4 9 -1 -1 8 13 9 -1 -1 -1 -1 2
2 -1 -1 -1 -1 -1 6 1 9 -1 -1 -1 -1 -1 -1 -1 -1 -1 -1 2
2 -1 -1 -1 -1 -1 -1 -1 -1 -1 -1 -1 -1 -1 -1 -1 -1 -1 -1 2
2 -1 -1 6 5 -1 -1 -1 -1 -1 -1 -1 -1 -1 10 -1 -1 -1 -1 2
2 -1 -1 -1 2 -1 -1 -1 -1 -1 -1 -1 -1 -1 2 -1 -1 -1 -1 2
8 1 1 1 13 1 1 1 1 1 1 1 1 1 13 1 1 1 1 9

-1 -1 -1 -1 -1 -1 -1 -1 -1 -1 -1 -1 -1 -1 -1 -1 -1 -1 -1 -1
-1 0 -1 -1 1 -1 2 -1 3 -1 4 -1 5 -1 6 -1 7 -1 8 -1
-1 -1 -1 -1 -1 -1 -1 -1 -1 -1 -1 -1 -1 -1 -1 -1 -1 -1 -1 -1
-1 9 -1 10 -1 11 -1 12 -1 13 -1 14 -1 15 -1 -1 -1 -1 -1 -1
-1 -1 -1 -1 -1 -1 -1 -1 -1 -1 -1 -1 -1 -1 -1 -1 -1 -1 -1 -1
-1 -1 -1 -1 -1 -1 -1 -1 -1 -1 -1 -1 -1 -1 -1 -1 -1 -1 -1 -1
-1 -1 -1 -1 -1 -1 -1 -1 -1 -1 -1 -1 -1 -1 -1 -1 -1 -1 -1 -1
-1 -1 -1 -1 -1 -1 -1 -1 -1 -1 -1 -1 -1 -1 -1 -1 -1 -1 -1 -1
-1 -1 -1 -1 -1 -1 -1 -1 -1 -1 -1 -1 -1 -1 -1 -1 -1 -1 -1 -1
-1 -1 -1 -1 -1 -1 -1 -1 -1 -1 -1 -1 -1 -1 -1 -1 -1 -1 -1 -1